WWWWWWWWWWWWWWWWWWWWWWWWWWWWWWWWWWWWWWWWWWWW
WPWPWPWPWPWPGWWWPPWPWPWPWPWPWWPPPPPPPPPPPPPW
WPPPPPPPPPPPPWWWPPPPWPWPWPWPWWPPPWWWPWWWPPPW
WWPWPWPWPWPWPWWWPPWPWPWPWPPPWWPPPWWWPWWWPPPW
WPPPPPPPPPPPPWWGPPWPWPWPWPWPWWPPPWWWPWWWPPPW
WPWPWPWPWPWPWWWWPPWPWPWPWPWPWWPPPWWWPWWWPPPW
WPPPPPPPPPPPPWWWPPWPWPPPPPWPWWPPPPWWPWWPPPPW
WWPWPWPWPWPWPWWWPPWPPPWPWPWPWWPPPPPWGWPPPPPW
WSPPPPPPPPPPPWWWPPWPWPWPWPWSWWSPPPPPWPPPPPPW
WWWWWWWWWWWWWWWWWWWWWWWWWWWWWWWWWWWWWWWWWWWW
WWWWWWWWWWWWWWWWWWWWWWWWWWWWWWWWWWWWWWWWWWWW
WWPPPPPPPPPPPWWGPPWPPPWPPPPWWWSPPPPPPPPPPPPW
WWPWPPPPPPPPPWWWWPPPWPPPPWPPWWWWWWWWPWWWWWWW
WWPWWPPWPWPPWWWWWWWWWWWWWWWPWWPPPPPPPPPPPPPW
WWPWPWPPPPPWPWWPPPPPPPPPPPPPWWWWPWWWWWWWWWWW
WWPWPPPWWWPPPWWPWWWWWWWWWWWWWWPPPPPPPPPPPPPW
WWPWPPPWGWPPPWWPPPPPPPPPPPPPWWWWWWWWWWWPWWWW
WWPWPWPPPPPWPWWWWWWWWWWWWWWPWWPPPWPPPWPPPPPW
WSPWWPPWPWPPWWWSPPPPPPPPPPPPWWGWPPPWPPPPPPPW
WWWWWWWWWWWWWWWWWWWWWWWWWWWWWWWWWWWWWWWWWWWW
WWWWWWWWWWWWWWWWWWWWWWWWWWWWWWWWWWWWWWWWWWWW
WPPPPPPPPPPPPWWSWPPPWPPPWPPPWWPPPPPPPPPPPPWW
WPWWWWWWWWWWPWWPWPWPWPWPWPWPWWPPPPPPPPPPWPWW
WPWPPPPPPPPWPWWPWPWPWPWPWPWPWWWPPPWPWPPWWPWW
WPWPWPPPPPGWPWWPWPWPWPWPWPWPWWPWPPPPPPWPWPWW
WPWPWWWWWWWWPWWPWPWPWPWPWPWPWWPPPPWWWPPPWPWW
WPWPPPPPPPPPPWWPWPWPWPWPWPWPWWPPPPWGWPPPWPWW
WPWWWWWWWWWWWWWPWPWPWPWPWPWPWWPWPPPPPPWPWPWW
WPPPPPPPPPPPSWWPPPWPPPWPPPWGWWWPPPWPWPPWWPSW
WWWWWWWWWWWWWWWWWWWWWWWWWWWWWWWWWWWWWWWWWWWW